510111111111110
010101000001010
010101001001010
111101011111011
100101010101010
100101010101010
100101010101010
100101010101000
100101110101111
100100100100010
100100100100010
100000100100010
100111100110010
100000111011000
111111000001119